@@@@@@@@@@@@@@@@@@@@@@@@@@@@@@@@@@@@@@@@@@@@@@@@@@@@@@@@@@@@@@@@@@@@@@@@@@@
@@@@@@@@@@@@@@@@@@@@@@@@@@@@@'~~~     ~~~`@@@@@@@@@@@@@@@@@@@@@@@@@@@@@@@@@
@@@@@@@@@@@@@@@@@@@@@@@@'                     `@@@@@@@@@@@@@@@@@@@@@@@@@@@@
@@@@@@@@@@@@@@@@@@@@@'                           `@@@@@@@@@@@@@@@@@@@@@@@@@
@@@@@@@@@@@@@@@@@@@'                               `@@@@@@@@@@@@@@@@@@@@@@@
@@@@@@@@@@@@@@@@@'                                   `@@@@@@@@@@@@@@@@@@@@@
@@@@@@@@@@@@@@@@'                                     `@@@@@@@@@@@@@@@@@@@@
@@@@@@@@@@@@@@@'                                       `@@@@@@@@@@@@@@@@@@@
@@@@@@@@@@@@@@@                                         @@@@@@@@@@@@@@@@@@@
@@@@@@@@@@@@@@'                                         `@@@@@@@@@@@@@@@@@@
@@@@@@@@@@@@@@                                           @@@@@@@@@@@@@@@@@@
@@@@@@@@@@@@@@                                           @@@@@@@@@@@@@@@@@@
@@@@@@@@@@@@@@                       n,                  @@@@@@@@@@@@@@@@@@
@@@@@@@@@@@@@@                     _/ | _                @@@@@@@@@@@@@@@@@@
@@@@@@@@@@@@@@                    /'  `'/                @@@@@@@@@@@@@@@@@@
@@@@@@@@@@@@@@a                 <~    .'                a@@@@@@@@@@@@@@@@@@
@@@@@@@@@@@@@@@                 .'    |                 @@@@@@@@@@@@@@@@@@@
@@@@@@@@@@@@@@@a              _/      |                a@@@@@@@@@@@@@@@@@@@
@@@@@@@@@@@@@@@@a           _/      `.`.              a@@@@@@@@@@@@@@@@@@@@
@@@@@@@@@@@@@@@@@a     ____/ '   \__ | |______       a@@@@@@@@@@@@@@@@@@@@@
@@@@@@@@@@@@@@@@@@@a__/___/      /__\ \ \     \___.a@@@@@@@@@@@@@@@@@@@@@@@
@@@@@@@@@@@@@@@@@@@/  (___.'\_______)\_|_|        \@@@@@@@@@@@@@@@@@@@@@@@@
@@@@@@@@@@@@@@@@@@|\________                       ~~~~~\@@@@@@@@@@@@@@@@@@
~~~\@@@@@@@@@@@@@@||       |\___________________________/|@/~~~~~~~~~~~\@@@
    |~~~~\@@@@@@@/ |  |    |   |   |      |     |   |  | ||\____________|@@


