  ----------                        
  -----   _..----.._      
        .'     o    '.    
       /   o       o  \   
      |o        o     o|  
      /'-.._o     __.-'\  
      \      `````     /  
      |``--........--'`|  
  ++++ \              /
        `'----------'`

ver1fi3d Bun