  =======================                        
          _..----.._     \
5495    .'     o    '.   \
       /   o       o  \  \
      |o        o     o| \
      /'-.._o     __.-'\ \
      \      `````     / \
      |``--........--'`| \
       \              /  \
        `'----------'`   \
  =======================

hehehe : )