                          
          _..----.._      
        .'     o    '.    
       /   o       o  \   
      |o        o     o|  
      /'-.._o     __.-'\  
      \      `````     /  
      |``--........--'`|  
       \              /
        `'----------'`

