                    ____
               .---[[__]]----.
              ;-------------.|       ____
              |             ||   .--[[__]]---.
              |             ||  ;-----------.|
              |             ||  |           ||
              |_____________|/  |           ||
                                |___________|/

